25 15
23 22 22 22 22 21 21 21 21 21 22 22 22 22 23 
22 22 22 22 21 21 21 21 21 21 21 22 22 22 22 
22 22 22 21 21 21 21 21 21 21 21 21 22 22 22 
22 22 21 21 21 21 21 21 21 21 21 21 21 22 22 
22 21 21 21 21 21 21 21 21 21 21 21 21 21 22 
21 21 21 21 21 21 21 21 21 21 21 21 21 21 21 
21 21 21 21 21 21 21 21 21 21 21 21 21 21 21 
21 21 21 21 21 21 21 21 21 21 21 21 21 21 21 
21 21 21 21 21 21 21 21 21 21 21 21 21 21 21 
21 21 21 21 21 21 21 21 21 21 21 21 21 21 21 
21 21 21 21 21 21 21 21 21 21 21 21 21 21 21 
21 21 21 21 21 21 21 21 21 21 21 21 21 21 21 
21 21 21 21 21 21 21 21 21 21 21 21 21 21 21 
21 21 21 21 21 21 21 21 21 21 21 21 21 21 21 
21 21 21 21 21 21 21 21 21 21 21 21 21 21 21 
21 21 21 21 21 21 21 21 21 21 21 21 21 21 21 
21 21 21 21 21 21 21 21 21 21 21 21 21 21 21 
21 21 21 21 21 21 21 21 21 21 21 21 21 21 21 
21 21 21 21 21 21 21 21 21 21 21 21 21 21 21 
21 21 21 21 21 21 21 21 21 21 21 21 21 21 22 
21 21 21 21 21 21 21 21 21 21 21 21 21 22 22 
22 21 21 21 21 21 21 21 21 21 21 21 22 22 22 
22 22 21 21 21 21 21 21 21 21 21 22 22 22 22 
22 22 22 21 21 21 21 21 21 21 22 22 22 22 23 
22 22 22 22 21 21 21 21 21 22 22 22 22 23 23 