21 15
21 21 21 21 21 21 21 21 21 21 21 21 21 21 21 
21 18 18 18 18 21 21 21 21 21 21 18 18 18 21 
21 18 18 18 21 21 21 21 21 21 21 21 18 18 21 
21 18 18 21 21 21 21 21 21 21 21 21 21 18 21 
21 18 21 21 21 21 21 21 21 21 21 21 21 21 21 
21 21 21 21 21 21 21 21 21 21 21 21 21 21 21 
21 21 21 21 21 21 21 21 21 21 21 21 21 21 21 
21 21 21 21 21 21 21 21 21 21 21 21 21 21 21 
21 21 21 21 21 21 21 21 21 21 21 21 21 21 21 
21 21 21 21 21 21 21 21 21 21 21 21 21 21 21 
21 21 21 21 21 21 21 21 21 21 21 21 21 21 21 
21 21 21 21 21 21 21 21 21 21 21 21 21 21 21 
21 21 21 21 21 21 21 21 21 21 21 21 21 21 21 
21 21 21 21 21 21 21 21 21 21 21 21 21 21 21 
21 21 21 21 21 21 21 21 21 21 21 21 21 21 21 
21 21 21 21 21 21 21 21 21 21 21 21 21 18 21 
21 21 21 21 21 21 21 21 21 21 21 21 18 18 21 
21 18 21 21 21 21 21 21 21 21 21 18 18 18 21 
21 18 18 21 21 21 21 21 21 21 18 18 18 18 21 
21 18 18 18 21 21 21 21 21 18 18 18 18 18 21 
21 21 21 21 21 21 21 21 21 21 21 21 21 21 21 