25 15
2 2 2 2 2 2 2 -1 2 2 2 2 2 2 2 
2 7 -1 -1 -1 -1 -1 -1 -1 -1 -1 -1 -1 7 2 
2 8 -1 -1 -1 -1 -1 -1 -1 -1 -1 -1 -1 8 2 
2 7 -1 -1 -1 -1 -1 -1 -1 -1 -1 -1 -1 7 2 
2 8 -1 -1 -1 -1 -1 -1 -1 -1 -1 -1 -1 8 2 
2 7 -1 -1 -1 -1 -1 -1 -1 -1 -1 -1 -1 7 2 
2 8 -1 -1 -1 -1 -1 -1 -1 -1 -1 -1 -1 8 2 
2 7 -1 -1 -1 -1 -1 -1 -1 -1 -1 -1 -1 7 2 
2 8 -1 -1 -1 -1 -1 -1 -1 -1 -1 -1 -1 8 2 
2 7 -1 -1 -1 -1 -1 -1 -1 -1 -1 -1 -1 -1 2 
2 8 -1 -1 -1 -1 -1 -1 -1 -1 -1 -1 -1 -1 2 
2 -1 -1 -1 -1 -1 -1 -1 -1 -1 -1 -1 -1 -1 2 
2 -1 -1 -1 -1 -1 -1 -1 -1 -1 -1 -1 -1 7 2 
2 -1 -1 -1 -1 -1 -1 -1 -1 -1 -1 -1 -1 8 2 
2 -1 -1 -1 -1 -1 -1 -1 -1 -1 -1 -1 -1 7 2 
2 -1 -1 -1 -1 -1 -1 -1 -1 -1 -1 -1 -1 8 2 
2 7 -1 -1 -1 -1 -1 -1 -1 -1 -1 -1 -1 7 2 
2 8 7 -1 -1 -1 -1 -1 -1 -1 -1 -1 7 8 2 
2 7 8 7 -1 -1 -1 -1 -1 -1 -1 7 8 7 2 
2 8 -1 8 -1 -1 -1 -1 -1 -1 -1 8 -1 8 2 
2 2 2 2 2 2 2 2 2 2 2 2 2 2 2 
7 7 7 7 7 7 7 7 7 7 7 7 7 7 7 
6 6 6 6 6 6 6 6 6 6 6 6 6 6 8 
5 5 5 5 5 5 5 5 5 5 5 5 5 5 7 
8 8 8 8 8 8 8 8 8 8 8 8 8 8 8 