25 15
-1 -1 -1 -1 -1 -1 -1 -1 -1 -1 -1 -1 -1 -1 -1 
5 -1 -1 -1 -1 -1 -1 -1 -1 -1 -1 3 5 -1 -1 
6 -1 -1 -1 -1 -1 -1 -1 -1 -1 -1 4 6 -1 -1 
5 -1 -1 -1 -1 -1 -1 -1 -1 -1 -1 3 5 -1 -1 
6 -1 -1 -1 -1 -1 -1 -1 -1 -1 -1 4 6 -1 -1 
5 -1 -1 -1 -1 -1 -1 -1 -1 -1 -1 3 5 -1 -1 
6 -1 -1 -1 -1 -1 -1 -1 -1 -1 -1 4 6 -1 -1 
5 -1 -1 -1 -1 -1 -1 -1 -1 -1 -1 3 5 -1 -1 
6 -1 -1 -1 -1 -1 -1 -1 -1 -1 -1 4 6 -1 -1 
5 -1 -1 -1 -1 -1 -1 -1 -1 -1 -1 -1 -1 -1 -1 
6 -1 -1 -1 -1 -1 -1 -1 -1 -1 -1 -1 -1 -1 -1 
-1 -1 -1 -1 -1 -1 -1 -1 -1 -1 -1 -1 -1 -1 -1 
-1 -1 -1 -1 -1 -1 -1 -1 -1 -1 -1 3 5 -1 -1 
-1 -1 -1 -1 -1 -1 -1 -1 -1 -1 -1 4 6 -1 -1 
-1 -1 -1 -1 -1 -1 -1 -1 -1 -1 -1 3 5 -1 -1 
-1 -1 -1 -1 -1 -1 -1 -1 -1 -1 -1 4 6 -1 -1 
5 -1 -1 -1 -1 -1 -1 -1 -1 -1 -1 -1 5 -1 -1 
6 5 -1 -1 -1 -1 -1 -1 -1 -1 -1 5 6 -1 -1 
5 6 5 -1 -1 -1 -1 -1 -1 3 5 6 5 -1 -1 
6 4 6 -1 -1 -1 -1 -1 -1 4 6 4 6 -1 -1 
-1 -1 -1 -1 -1 -1 -1 -1 -1 -1 -1 -1 -1 -1 -1 
5 5 5 5 5 5 5 5 5 5 5 5 5 5 -1 
5 5 5 5 5 5 5 5 5 5 5 5 5 5 -1 
6 6 6 6 6 6 6 6 6 6 6 6 6 6 -1 
6 6 6 6 6 6 6 6 6 6 6 6 6 6 -1 