25 15
7 -1 7 -1 7 -1 7 -1 7 -1 7 -1 7 -1 7 
8 7 8 7 8 7 8 7 8 7 8 7 8 7 8 
7 8 7 8 7 8 7 8 7 8 7 8 7 8 7 
8 7 8 7 8 7 8 7 8 7 8 7 8 7 8 
7 8 7 8 7 8 7 8 7 8 7 8 7 8 7 
8 7 8 7 8 7 8 7 8 7 8 7 8 7 8 
7 8 7 8 7 8 7 8 7 8 7 8 7 8 7 
8 -1 8 -1 8 -1 8 -1 8 -1 8 -1 8 -1 8 
7 -1 -1 -1 -1 -1 -1 -1 -1 -1 -1 -1 -1 -1 7 
8 -1 -1 -1 -1 -1 -1 -1 -1 -1 -1 -1 -1 -1 8 
7 -1 -1 -1 -1 -1 -1 -1 -1 -1 -1 -1 -1 -1 7 
8 -1 -1 -1 -1 -1 -1 -1 -1 -1 -1 -1 -1 -1 8 
-1 -1 -1 -1 -1 -1 -1 -1 -1 -1 -1 -1 -1 -1 0 
7 -1 -1 -1 -1 -1 -1 -1 -1 -1 -1 -1 -1 -1 7 
8 -1 -1 -1 -1 -1 -1 -1 -1 -1 -1 -1 -1 -1 8 
7 -1 -1 -1 -1 -1 -1 -1 -1 -1 -1 -1 -1 -1 7 
8 -1 -1 -1 -1 -1 -1 -1 -1 -1 -1 -1 -1 -1 8 
7 -1 7 -1 7 -1 7 -1 7 -1 7 -1 7 -1 7 
8 7 8 7 8 7 8 7 8 7 8 7 8 7 8 
7 8 7 8 7 8 7 8 7 8 7 8 7 8 7 
8 7 8 7 8 7 8 7 8 7 8 7 8 7 8 
7 8 7 8 7 8 7 8 7 8 7 8 7 8 7 
8 7 8 7 8 7 8 7 8 7 8 7 8 7 8 
7 8 7 8 7 8 7 8 7 8 7 8 7 8 7 
8 -1 8 -1 8 -1 8 -1 8 -1 8 -1 8 -1 8 