21 15
2 2 2 2 2 2 2 2 2 2 2 2 15 15 15 
-1 -1 -1 -1 -1 -1 -1 -1 -1 -1 -1 15 15 15 2 
2 -1 -1 -1 -1 -1 -1 -1 -1 -1 -1 15 15 -1 2 
2 -1 -1 12 13 9 -1 -1 15 12 13 9 15 -1 2 
2 -1 -1 12 11 9 -1 -1 15 12 11 9 15 -1 2 
2 -1 -1 12 13 10 -1 -1 15 12 11 10 15 -1 2 
15 15 -1 12 11 9 -1 -1 15 16 16 9 15 -1 2 
15 15 15 12 13 9 -1 -1 15 15 15 15 15 -1 2 
2 15 15 15 15 15 -1 -1 15 15 15 15 15 -1 2 
2 -1 15 15 15 15 -1 -1 15 12 11 9 15 15 2 
2 -1 15 15 15 15 -1 -1 15 12 13 9 15 15 2 
2 -1 -1 12 13 9 -1 -1 15 12 11 10 15 15 2 
2 -1 -1 12 11 10 -1 -1 15 12 16 9 15 15 2 
2 -1 -1 12 11 9 -1 -1 -1 15 15 15 15 15 2 
2 -1 -1 12 11 9 -1 -1 -1 -1 15 15 15 15 15 
2 -1 -1 15 15 9 -1 -1 -1 -1 -1 15 15 15 15 
2 -1 -1 15 15 15 -1 -1 -1 -1 -1 -1 15 15 15 
2 -1 -1 -1 15 15 15 -1 -1 -1 -1 -1 15 15 15 
2 -1 -1 -1 15 15 15 -1 -1 -1 -1 -1 15 15 15 
2 15 15 15 15 15 15 -1 -1 -1 -1 -1 15 15 15 
15 15 15 15 15 15 15 2 2 2 2 2 2 15 15 