20 15
1 1 1 1 1 1 1 1 1 1 1 1 1 1 1 
1 -1 -1 -1 -1 -1 -1 -1 -1 -1 -1 -1 -1 -1 1 
1 -1 -1 -1 -1 -1 -1 -1 -1 -1 -1 -1 -1 -1 1 
1 -1 1 1 1 1 1 1 1 1 1 1 1 -1 1 
1 -1 -1 -1 1 -1 -1 -1 -1 -1 -1 -1 1 -1 1 
1 -1 1 -1 1 -1 -1 1 -1 1 -1 -1 1 -1 1 
1 -1 1 -1 1 1 -1 1 -1 1 -1 -1 1 -1 1 
1 -1 1 -1 1 -1 -1 1 -1 1 -1 -1 1 -1 1 
1 -1 1 -1 1 -1 1 1 -1 1 -1 -1 1 -1 1 
1 -1 1 -1 1 -1 -1 1 -1 1 -1 -1 1 -1 1 
1 -1 1 -1 1 1 -1 1 -1 1 -1 -1 1 -1 1 
1 -1 1 -1 1 -1 -1 1 -1 1 -1 -1 1 -1 1 
1 -1 1 -1 1 -1 1 1 -1 1 -1 -1 1 -1 1 
1 -1 1 -1 -1 -1 -1 1 -1 1 -1 -1 1 -1 1 
1 -1 1 1 1 1 1 1 -1 1 1 1 1 -1 1 
1 -1 -1 -1 -1 -1 -1 -1 -1 -1 -1 -1 -1 -1 1 
1 -1 -1 -1 -1 -1 -1 -1 -1 -1 -1 -1 -1 -1 1 
1 -1 -1 -1 -1 -1 -1 -1 -1 -1 -1 -1 -1 -1 1 
1 -1 -1 -1 -1 -1 -1 -1 -1 -1 -1 -1 -1 -1 1 
1 1 1 1 1 1 1 1 1 1 1 1 1 1 1 