21 15
2 2 2 2 2 -1 2 2 2 2 2 2 2 2 2 
2 -1 -1 -1 -1 -1 -1 -1 -1 -1 -1 -1 -1 -1 2 
2 -1 -1 -1 -1 -1 -1 -1 -1 -1 -1 -1 -1 -1 2 
2 -1 -1 12 9 -1 -1 -1 -1 12 13 9 -1 -1 2 
2 -1 -1 12 11 -1 -1 -1 -1 12 11 9 -1 -1 2 
2 -1 -1 12 10 -1 -1 -1 -1 12 13 10 -1 -1 2 
2 -1 -1 12 9 -1 -1 -1 -1 12 11 9 -1 -1 2 
2 -1 -1 -1 -1 -1 -1 -1 -1 12 13 9 -1 -1 2 
2 -1 -1 -1 -1 -1 -1 -1 -1 -1 -1 -1 -1 -1 2 
2 -1 -1 12 9 -1 -1 -1 -1 -1 -1 -1 -1 -1 2 
2 -1 -1 12 9 -1 -1 -1 -1 -1 -1 -1 -1 -1 2 
2 -1 -1 12 10 -1 -1 -1 -1 -1 -1 -1 -1 -1 2 
2 -1 -1 12 9 -1 -1 -1 -1 -1 -1 -1 -1 -1 2 
2 -1 -1 -1 -1 -1 -1 12 13 9 -1 -1 -1 -1 2 
2 -1 -1 -1 -1 -1 -1 12 11 9 -1 -1 -1 -1 2 
2 -1 -1 12 9 -1 -1 12 11 10 -1 -1 -1 -1 2 
2 -1 -1 12 10 -1 -1 12 11 9 -1 -1 -1 -1 2 
2 -1 -1 12 11 -1 -1 12 11 9 -1 -1 -1 -1 2 
2 -1 -1 12 9 -1 -1 12 13 9 -1 -1 -1 -1 2 
2 -1 -1 -1 -1 -1 -1 -1 -1 -1 -1 -1 -1 -1 2 
2 2 2 2 2 2 2 2 2 2 2 2 2 2 2 